1 8 1593 6034 2633 391 5457 1564 1255 174
1 7 174 2370 202 1623 3386 4133 5251
1 6 202 421 1795 6127 2297 2912
1 4 174 4553 591 4429
1 2 4429 2334
1 10 933 5502 5726 3245 6160 5337 3603 6216 6269 5599
1 10 5599 483 622 5328 1488 6222 2291 1373 6187 2731
1 4 5599 6300 4293 2423
1 7 5599 2397 5723 6391 2705 6473 6518 
1 2 1577 6400
1 4 6400 5581 3466 1103
1 3 1103 6569 6551 
1 10 5599 5638 3146 3462 20 300 3710 2161 6520 6551 
1 10 6551 1123 3062 6747 3302 6863 5677 4338 7067 7118 
1 7 5885 1452 8316 2555 6054 3149 933
1 4 20 4526 5081 6568