1 8 1593 6034 2633 391 5457 1564 1255 174
1 7 174 2370 202 1623 3386 4133 5251
1 6 202 421 1795 6127 2297 2912
1 4 174 4553 591 4429
1 2 4429 2334
1 10 933 5502 5726 3245 6160 5337 3603 6216 6269 5599
1 10 5599 483 622 5328 1488 6222 2291 1373 6187 2731
1 4 5599 6300 4293 2423
1 7 5599 2397 5723 6391 2705 6473 6518 
1 2 1577 6400
1 4 6400 5581 3466 1103
1 3 1103 6569 6551 
1 10 5599 5638 3146 3462 20 300 3710 2161 6520 6551 
1 10 6551 1123 3062 6747 3302 6863 5677 4338 7067 7118 
1 7 5885 1452 8316 2555 6054 3149 933
1 4 20 4526 5081 6568
1 5 5199 7213 4946 5005 7230
1 6 4946 7106 1751 3281 3196 2929
1 3 2929 6813 5148
1 8 5148 1877 6738 3811 217 1595 6798 43
1 3 43 5749 6988
1 7 6988 4501 7107 7187 3096 7189 3479
1 11 6988 1437 5632 1501 6967 4813 1252 4057 3162 6823 6764
3 3 6977 7023 2043
3 3 6977 6934 6935
3 4 6935 4681 1780 1661
3 2 1661 4351
3 2 1661 6964
3 3 6964 1436 4053
1 5 1661 759 2080 4394 4053
3 4 6935 3848 5327 6759
3 6 2043 4747 7003 6991 2537 5006
3 3 5006 1152 2362
3 5 5006 7040 1349 7119 3580
3 3 3580 3384 600
2 8 600 2588 7217 7179 637 5771 7091 2043